071 071 071 071 071 071 071 071 071 071 071 071 071 071 071 071 071 071 071 071 071 071 071 057 057
057 055 051 065 065 065 065 065 065 065 065 065 065 065 065 065 065 065 065 065 065 052 055 057 057
057 055 058 048 049 049 049 049 049 049 049 049 049 049 049 049 049 049 049 049 050 056 055 057 057
057 055 058 056 071 071 071 071 071 071 071 071 071 071 071 071 071 071 071 071 058 056 055 057 057
057 055 058 056 055 057 057 057 057 057 057 057 057 057 057 057 057 057 057 055 058 056 055 057 057
057 055 058 056 071 071 071 071 071 071 071 071 071 071 071 057 057 057 057 055 058 056 055 057 057
057 055 058 064 065 065 065 065 065 065 065 065 065 052 055 057 057 057 057 055 058 056 055 057 057
057 055 059 049 049 049 049 049 049 049 049 049 050 056 055 057 057 057 057 055 058 056 055 057 057
057 071 071 071 071 071 071 071 071 071 071 071 058 056 055 057 057 057 057 055 058 056 055 057 057
057 057 057 057 057 057 057 057 057 057 057 055 058 056 055 057 057 057 057 055 058 056 055 057 057
057 057 057 057 057 057 057 057 057 057 057 055 058 056 055 057 057 057 057 055 058 056 055 057 057
071 071 071 071 071 071 071 071 071 071 071 071 058 056 055 057 057 057 057 055 058 056 071 071 071
065 065 065 065 065 065 065 065 065 065 065 065 066 056 055 057 057 057 057 055 058 064 065 065 065
049 049 049 049 049 049 049 049 049 049 049 049 049 060 055 057 057 057 057 055 059 049 049 049 049
071 071 071 071 071 071 071 071 071 071 071 071 071 071 071 057 057 057 057 071 071 071 071 071 071

